111111111111115555555555112200000011110000001111111111100111001001111111100011111111111111
1011111511111555111555511111a6000001000000002011011100022021110222110122111110211111111111
111111511111115115115555111106600070000000022001001110222222222222212222211220211220000111
11111141111111111511151111100060777007000020222a000002222220222222222222222222212220022001
11111144111111110521151111002066a000777702222266022022222222222222222222222222222222222001
111101122041110022221112122220007000000770222260222222222222222202222222222222222222222511
111001526a117702222222a22222220777000077027222a7722222222222222222222222222222222222222511
111111222011a07722222272222202000700007007722275722222220222220222222222222222222222225511
11111111111177722222277722542000077000777a020275252222202002550225225555525222222222255111
111111111102227227722222255440077700777006002225522222200055525555555555555555552222255111
111111000a62222225777722555440007000070506666052500202005553555444554005505555555522551111
11111110226a772555525777a5550200000000005000a005550100005333334444444440050050055555551111
1111111122272a5555555555666600011000110445511115511100053333334444444400000077005555511155
111111111222222555555555555620011101111445111145511000053333333444444070077770005555111511
111111111222225555522255577a6a111111111151111455014000533333334444444770007000001115511551
11111111122272255222011555555011111111115511115554450553333550444444447777a006a11115515511
1111005555227a2502240111455555011100111155511155545555555555454444444554006666001111115111
111104445555111111104411115500010000005555541155455554555555555444400444400000001111111111
111144444455111111110441115550110000055555444444544445555545555544407740077000000111151111
111144444001111115111044111555111111115555444444555445555544555554440770007000000111111111
11114444001111111111111454115115111111555440044455554455455555555554057777a00066a111111111
111114440111111115111115111111511111110444070400555554445755555555545550006666600111111111
111111151111111111111115111511111111145444070007045505444772555455555552000600000111111111
111111111111111111115511111111111101145444077007044577444077255545555552222000000511111111
111111110055440000111151111111111111455444007077004570400007255555575552222222005511111111
1111111055543334440011111111111111114553440077700446a000007a622255775555222772200115111111
111111055533333334401111111111111134533333000a00444600000002a1125775555552227777a155111111
111115555333333333401111333333a33353333333311110544a000000002111a7555775522222200151111111
111115333333333333443433333333633133333333331111111100000000111125552272221222011111111111
011113333333333333334333333333633133333333333135511110000000111112552277a11112111111111111
111133333333333333333333333336644113333333333333111110000001111111252222211111111112111111
111333333333333333333333333336444411333333333331111111000001111111122222221115111112111111
111333333333335553333333333336a75441133333333311111111100001111111122222222111111122111111
111333333300300050033353333335755554113333333111111111100011111111122112222111111112211111
1111a7700000000000000033333555777555411113311111111111100111111111112111221111111112121111
111000700777700000070000000007707055443311111111111111110111111111111211211111111112111111
111000000700700000077700000000577054433333111111111111111111111111111121111111111111112111
1110000000007777722070000000051a5555333341111111111111111121111111111101111111121211212111
111000000002022277777020000000105543334311111111111111111211111111211111111112111111121111
111002022222222772222222000000005444441111111111111111111111111111152211111111112121111111
111102222222222a22222222200000005444411111111111111111111111111111125522111252511152121111
111112222222222622222222022000000004111111111111111111111111111111112551112555112511111111
111112222211212a22227722220005000001111111111111111111111111111111111555112565115522111211
1111111211111111222272772202005000110111111111121111111111111111111112551112a2112111111111
11111111111111111222a772222000500010111111111111111111113111111111111115111111111112221111
111111111111111112666222772202050111111111111121111111111111111111111111121111111112555511
11111111111111111a626272722220021111111111111121111111111111111111111111252252211122552251
1111111111111111122266a7722202201111111111112111111111111111111111111111115555221111125221
111111111111111111222227222200200111111211111111111111111111111111111111111111111111111521
111111111111111111222777222020020111152111111111111111111111111111111111111111111111111121
111111111111111111222722242700000111552111111111111111111111111111111111111111111111111111
111111111111111111222024422770000115252111111111111111111111111111111111111111111111112111
111111111111111113502244740070000115521111111111111111111111111111111111111111111222112211
1111111111111111135044447777a6a11115211111111111111111111111111111111111111111112332212221
111111111111111111004444744440011151111111111111111111111111111111111111111111033333332521
111111111111111111004444444400111111111111111111111111111111111111111111111110333333333521
111111111111111111100040040000111111111111111111111111111111111111111111111110333333335521
111111111111111111110000000011111111111111111111111111111111111111111111111112111133552211
111111111111111111111000111111111111111111111111111111111111111111111111111111111110222111
111111111111111111111111111111111111111111111111111111111111111111111111111111111111111111